LEFT=слева
MIDDLE=по центру
RIGHT=справа
UP=сверху
DOWN=снизу
person=человек
bicycle=велосипед
car=автомобиль
motorcycle=мотоцикл
airplane=самолет
bus=автобус
train=поезд
truck=грузовик
boat=лодка
traffic light=светофор
fire hydrant=пожарный гидрант
stop sign="знак ""стоп"""
parking meter=парковочный счетчик
bench=скамейка
bird=птица
cat=кошка
dog=собака
horse=лошадь
sheep=овца
cow=корова
elephant=слон
bear=медведь
zebra=зебра
giraffe=жираф
backpack=рюкзак
umbrella=зонт
handbag=дамская сумка
tie=галстук
suitcase=чемодан
frisbee=фрисби (летающая тарелка)
skis=лыжи
snowboard=сноуборд
sports ball=спортивный мяч
kite=воздушный змей
baseball bat=бейсбольная бита
baseball glove=бейсбольная перчатка
skateboard=скейтборд
surfboard=доска для серфинга
tennis racket=теннисная ракетка
bottle=бутылка
wine glass=бокал
cup=чашка
fork=вилка
knife=нож
spoon=ложка
bowl=миска
banana=банан
apple=яблоко
sandwich=бутерброд
orange=апельсин
broccoli=брокколи
carrot=морковь
hot dog=хот-дог
pizza=пицца
donut=пончик
cake=торт
chair=стул
couch=диван
potted plant=комнатное растение
bed=кровать
dining table=обеденный стол
toilet=унитаз
tv=телевизор
laptop=ноутбук
mouse=компьютерная мышь
remote=пульт дистанционного управления
keyboard=клавиатура
cell phone=мобильный телефон
microwave=микроволновая печь
oven=духовка
toaster=тостер
sink=раковина
refrigerator=холодильник
book=книга
clock=часы
vase=ваза
scissors=ножницы
teddy bear=плюшевый медведь
hair drier=фен
toothbrush=зубная щетка